NO ./image/textureN.xpm
EA ./image/textureE.xpm
SO ./image/textureS.xpm
WE ./image/textureW.xpm

F 224,172,105
C 205,249,255

1111111111
1000000001
1000100001
1001110001
1000100001
1000N00001
1111111111
