F       5,   130,5
 

 
NO ./image/textureN.xpm

EA ./image/textureE.xpm

SO./image/textureS.xpm

WE ./image/textureW.xpm
C      0,0,41
11111111111111111111111111111111111111111111                                                                              11111111111111111111111111111
     11111111111111111111111111111111111111111111111
        1000000000110000000000001101  110011
        101100000111000000000000111   10001
        1111111111111111111111111111111111111111111111
                                                              
        1111111111111111111111111111111111111111111111111
        100100000000000000000000111   111111
111111111011000001110000000000001
1100000000011000001110111111111111
1111011111111101110000010001
11110000111111011101010010001                                             1
11000000010101111110000001000111                                    1111111
10000000000001 10001100000010001                                     11101
100E00000000011110011010100100011                                     11101111
11000000001011111111110000111111                                    111  11111
1111011001110101 10111101000111
1111111111111111 111111111111
1111111
1111111
1111111
1   
111
111
11
1


 

  
   
