
C50,50,120
F100,50,50

NO /home/ccravero/Cub3D//image/textureN.xpm
SO /home/ccravero/Cub3D//image/textureS.xpm
WE /home/ccravero/Cub3D//image/textureW.xpm
EA /home/ccravero/Cub3D//image/textureE.xpm

111111111
11000N01
110000001
11111111

