
C50,255,120
F100,50,50

NO ./image/textureN.xpm
SO ./image/textureS.xpm
WE ./image/textureW.xpm





EA ./image/textureE.xpm

11111
10111
10111
10111
10101
10101
1N011
11111


